11111111111111111
1C001100C000C00E1
1100C000111111001
1P00001100000C001
11111111111111111