11111111111111111
10001100000P000E1
1100C000011111001
100C001100C001001
11111111111111111
