11111111111111111111111111111
100010000000000000000000000E1
1100C0CP000111110000000000001
100C010C00C001C00000011111001
111111C0000001110000C00000111
11111111111111111111111111111
