111111111111111111111111111
10001100000P0000000000000E1
1100C0000111111100000000001
100C011100C001C000111110001
111111C0000001110000C000111
111111111111111111111111111
