111111111111111111111111111
1000100100000000000000000E1
1100C01P1001111100000000001
100C010000C001C000111110001
111111C0000001110000C000111
111111111111111111111111111