11111111111111111
10001100000P000E1
11000000111111001
1000001100C000001
11111111111111111
