111111111111111111111111111
1000100000000000000000000E1
1100C0CP0001111100000000001
100C010C00C001C000111110001
111111C0000001110000C000111
111111111111111111111111111
